........■■■■■.................
..■■■■■■■■■■■.................
.■■■■■■■■■■■..................
.■■■■■■■■.....................
..............................
.■■■■■■.......................
.■■■■■■■■.....................
..■■■■■■■■■...................
....■■■■■■■■..................
.......■■■■■■.................