.........■■■■■...■■■■■■■■■....
■■■........■■■..............■■
■■■........■■■................
■■■........■■■................
..............................
■■■.......■■■.......■■■.......
■■■........■■■......■■■.......
■■■........■■■......■■■.......
■■■........■■■......■■■.......
....■..■■■■■■■...■■■■■■■■■■■..