..............................
..............................
..■■■■■■■■■■■■■■■■■■■■■■■.....
..■■■..........■■■■■■■■■■.....
..■■■..........■■■■■■■■■■.....
..■■■.........................
..■■■..........■■■■■■■■■■.....
..■■■..........■■■■■■■■■■.....
..■■■■■■■■■■■■■■■■■■■■■■■.....
..............................