...■■■■■■■■■■...■■■■■■■■■■■...
..■■■■■■■■■■■...■■■■■■........
.■■■■■■■■■■■■...■■■■.....■■■■■
.■■■■■■■■■■.......■■■■..■■■■■■
..............................
.■■■■...■■■.......■■■■■■■■■.■■
.■■■■...■■■■■...■■■■■■■■■■■.■■
.■■■■...■■■■■...■■■■■■■■■.....
.■■■■...■■■■■...■■■■■■■■■.....
..■■■...■■■■■...■■■■■■■■■.....