..............................
■■■..................■■■■■■■■■
■■■■..................■■■■■■■■
■■■■.....................■■■■■
.■■■■.........................
..............................
..............................
■■■.......................■■■■
........................■■■■■■
.....................■■■■■■■■■