........■■■■■.................
..■■■■■■■■■■■.................
.■■■■■■■■■■■..................
■■■■■■■■■.....................
..............................
■■■■■■■.......................
■■■■■■■■■.....................
..■■■■■■■■■...................
....■■■■■■■■..................
.......■■■■■■.................