..............................
..............................
...■■■■■■■......■■■■■■■■■■■■■■
...■.....■......■.....■.......
...■.....■......■.....■.......
...■■..■■■......■■■...■..■■■■■
..............................
...................■...■......
.......■....■......■■■■■......
.......■■■■■■.................