..............................
..............■■■■............
............■■■■■■■...........
....■■■■■■■■■■■■■■■■■■■■■.....
..■■■■■■■■■■■■■■■■■■■■■.......
............■■■■■■■■■.........
..............■■■■............
..............■■■■............
..............■■■■............
..............................