...■■■■■■■■■■...■■■■■■■■■■■...
..■■■■■■■■■■■...■■■■■■........
.■■■■■■■■■■■■...■■■■.....■■■■■
■■■■■■■■■■■.......■■■■..■■■■■■
..............................
■■■■■...■■■.......■■■■■■■■■■■■
■■■■■...■■■■■...■■■■■■■■■■■■■■
■■■■■...■■■■■...■■■■■■■■■.....
.■■■■...■■■■■...■■■■■■■■■.....
..■■■...■■■■■...■■■■■■■■■.....