.....■....■.....■....■........
.....■....■.....■....■........
.....■....■.....■....■........
.....■..........■....■........
.....■....■.....■....■........
.....■....■.....■....■........
.....■....■.....■....■........
..........■.....■....■........
.....■....■...................
.....■....■.....■....■........