.....■........................
..............................
...............■..............
■..............■..............
...............■..............
...............■..............
■■■■.■■■■■■■■■■■■■■■■■■■■■■■■■
..............................
......................■.......
......................■.......