..............................
...■■■■■■■■■■■■■■■■■■■■■..■■■■
...■..........................
...■..........................
...■..........................
...■..........................
...■.................■........
...■.................■........
...■.................■........
...■.................■........