.........................■■...
..............................
.....■...................■■...
.....■...................■■...
.....■...................■■...
.....■...................■■...
.........................■■...
■■.....■■■■■■■■■■■■■■■■■■■■■■■
..............................
..............................