..............■■■■............
.....■■■■.........■■■■■■■■....
......................■■■■■■..
..........■■■■................
.......■■■■■■■■■■■■■■■■.......
..............■■■■■■■■■■......
........■■■■■■■■■■............
..........■■..................
......................■■■■■■..
..............................