..............................
.......■■■■■■■■■■■■■■■■■■■■■■■
............■■■■■■■■■■■■■■■■■■
................■■■■■■■■■■■■■■
...................■■■■■■■■■..
■■■■..........................
■■■■■■........................
■■■■■■■...................■■■■
■■■■■■■■■■..............■■■■■■
■■■■■■■■■■■■.........■■■■■■■■■