■■■■■■■■■■■■■■..■■■■■■■■■■■■■■
■■■■■■■■■■■■....■■■■■■■■■■■■■■
■■■■............■■■■■■■■■■■■■■
■■■■.............■■■■■■■■■■■■■
...■■■...............■■■■■■■■.
.........■■...................
.......■■■■■■.................
■■■......■■...............■■■■
........................■■■■■■
.....................■■■■■■■■■