..............................
■■■■■■■■■■■■■■■■■■■■■■■...■■■■
.........................■....
.........................■....
...............■■■■■■■■■■■....
.....................■........
.....................■........
.....................■........
.....■........................
.....■...............■........