..............................
■■■■■■■■■■■■...■■■■■■■■■■■■■■■
..............................
■■■■■■■■■■■■...■■■■■■■■■■■■■■■
..............................
■■■■■■■■■■■■...■■■■■■■■■■■■■■■
........■■............■■......
........■■............■■......
■■■■■■■■■■■■...■■■■■■■■■■■■■■■
..............................