........■■■■....■■■■■.........
..........■■...■■.......■■■...
...■■■■■■■....■■■■■....■■■■■■■
...■..■■■■....■■■......■■■....
...■...■■■...■■■.■............
...■■..■■■...■■■.■■■...■■■.■■■
......................■■■.....
...■■■......■■■....■.■■■......
.......■....■■■....■■■■■......
.......■■■■■■.................